,balance_of_Token_A,balance_of_Token_B,weight_of_token_A,weight_of_token_B,swap_fee,amount_token_B,price_of_token_B,simulation,subset,run,substep,timestep,par_weight_token_B
0,100,100,0.5,0.5,0,1,1,0,0,1,0,0,0.5
1,99.00990099,101,0.5,0.5,0,1,1,0,0,1,1,1,0.5
2,98.01980198,102,0.5,0.5,0,1,1,0,0,1,1,2,0.5
3,97.02970297,103,0.5,0.5,0,1,1,0,0,1,1,3,0.5
4,96.03960396,104,0.5,0.5,0,1,1,0,0,1,1,4,0.5
5,95.04950495,105,0.5,0.5,0,1,1,0,0,1,1,5,0.5
6,94.05940594,106,0.5,0.5,0,1,1,0,0,1,1,6,0.5
7,93.06930693,107,0.5,0.5,0,1,1,0,0,1,1,7,0.5
8,92.07920792,108,0.5,0.5,0,1,1,0,0,1,1,8,0.5
9,91.08910891,109,0.5,0.5,0,1,1,0,0,1,1,9,0.5
10,90.0990099,110,0.5,0.5,0,1,1,0,0,1,1,10,0.5
11,89.10891089,111,0.5,0.5,0,1,1,0,0,1,1,11,0.5
12,88.11881188,112,0.5,0.5,0,1,1,0,0,1,1,12,0.5
13,87.12871287,113,0.5,0.5,0,1,1,0,0,1,1,13,0.5
14,86.13861386,114,0.5,0.5,0,1,1,0,0,1,1,14,0.5
15,85.14851485,115,0.5,0.5,0,1,1,0,0,1,1,15,0.5
16,84.15841584,116,0.5,0.5,0,1,1,0,0,1,1,16,0.5
17,83.16831683,117,0.5,0.5,0,1,1,0,0,1,1,17,0.5
18,82.17821782,118,0.5,0.5,0,1,1,0,0,1,1,18,0.5
19,81.18811881,119,0.5,0.5,0,1,1,0,0,1,1,19,0.5
20,80.1980198,120,0.5,0.5,0,1,1,0,0,1,1,20,0.5
21,79.20792079,121,0.5,0.5,0,1,1,0,0,1,1,21,0.5
22,78.21782178,122,0.5,0.5,0,1,1,0,0,1,1,22,0.5
23,77.22772277,123,0.5,0.5,0,1,1,0,0,1,1,23,0.5
24,76.23762376,124,0.5,0.5,0,1,1,0,0,1,1,24,0.5
25,75.24752475,125,0.5,0.5,0,1,1,0,0,1,1,25,0.5
26,74.25742574,126,0.5,0.5,0,1,1,0,0,1,1,26,0.5
27,73.26732673,127,0.5,0.5,0,1,1,0,0,1,1,27,0.5
28,72.27722772,128,0.5,0.5,0,1,1,0,0,1,1,28,0.5
29,71.28712871,129,0.5,0.5,0,1,1,0,0,1,1,29,0.5
30,70.2970297,130,0.5,0.5,0,1,1,0,0,1,1,30,0.5
31,69.30693069,131,0.5,0.5,0,1,1,0,0,1,1,31,0.5
32,68.31683168,132,0.5,0.5,0,1,1,0,0,1,1,32,0.5
33,67.32673267,133,0.5,0.5,0,1,1,0,0,1,1,33,0.5
34,66.33663366,134,0.5,0.5,0,1,1,0,0,1,1,34,0.5
35,65.34653465,135,0.5,0.5,0,1,1,0,0,1,1,35,0.5
36,64.35643564,136,0.5,0.5,0,1,1,0,0,1,1,36,0.5
37,63.36633663,137,0.5,0.5,0,1,1,0,0,1,1,37,0.5
38,62.37623762,138,0.5,0.5,0,1,1,0,0,1,1,38,0.5
39,61.38613861,139,0.5,0.5,0,1,1,0,0,1,1,39,0.5
40,60.3960396,140,0.5,0.5,0,1,1,0,0,1,1,40,0.5
41,59.40594059,141,0.5,0.5,0,1,1,0,0,1,1,41,0.5
42,58.41584158,142,0.5,0.5,0,1,1,0,0,1,1,42,0.5
43,57.42574257,143,0.5,0.5,0,1,1,0,0,1,1,43,0.5
44,56.43564356,144,0.5,0.5,0,1,1,0,0,1,1,44,0.5
45,55.44554455,145,0.5,0.5,0,1,1,0,0,1,1,45,0.5
46,54.45544554,146,0.5,0.5,0,1,1,0,0,1,1,46,0.5
47,53.46534653,147,0.5,0.5,0,1,1,0,0,1,1,47,0.5
48,52.47524752,148,0.5,0.5,0,1,1,0,0,1,1,48,0.5
49,51.48514851,149,0.5,0.5,0,1,1,0,0,1,1,49,0.5
50,50.4950495,150,0.5,0.5,0,1,1,0,0,1,1,50,0.5
51,49.5049505,151,0.5,0.5,0,1,1,0,0,1,1,51,0.5
52,48.51485149,152,0.5,0.5,0,1,1,0,0,1,1,52,0.5
53,47.52475248,153,0.5,0.5,0,1,1,0,0,1,1,53,0.5
54,46.53465347,154,0.5,0.5,0,1,1,0,0,1,1,54,0.5
55,45.54455446,155,0.5,0.5,0,1,1,0,0,1,1,55,0.5
56,44.55445545,156,0.5,0.5,0,1,1,0,0,1,1,56,0.5
57,43.56435644,157,0.5,0.5,0,1,1,0,0,1,1,57,0.5
58,42.57425743,158,0.5,0.5,0,1,1,0,0,1,1,58,0.5
59,41.58415842,159,0.5,0.5,0,1,1,0,0,1,1,59,0.5
60,40.59405941,160,0.5,0.5,0,1,1,0,0,1,1,60,0.5
61,39.6039604,161,0.5,0.5,0,1,1,0,0,1,1,61,0.5
62,38.61386139,162,0.5,0.5,0,1,1,0,0,1,1,62,0.5
63,37.62376238,163,0.5,0.5,0,1,1,0,0,1,1,63,0.5
64,36.63366337,164,0.5,0.5,0,1,1,0,0,1,1,64,0.5
65,35.64356436,165,0.5,0.5,0,1,1,0,0,1,1,65,0.5
66,34.65346535,166,0.5,0.5,0,1,1,0,0,1,1,66,0.5
67,33.66336634,167,0.5,0.5,0,1,1,0,0,1,1,67,0.5
68,32.67326733,168,0.5,0.5,0,1,1,0,0,1,1,68,0.5
69,31.68316832,169,0.5,0.5,0,1,1,0,0,1,1,69,0.5
70,30.69306931,170,0.5,0.5,0,1,1,0,0,1,1,70,0.5
71,29.7029703,171,0.5,0.5,0,1,1,0,0,1,1,71,0.5
72,28.71287129,172,0.5,0.5,0,1,1,0,0,1,1,72,0.5
73,27.72277228,173,0.5,0.5,0,1,1,0,0,1,1,73,0.5
74,26.73267327,174,0.5,0.5,0,1,1,0,0,1,1,74,0.5
75,25.74257426,175,0.5,0.5,0,1,1,0,0,1,1,75,0.5
76,24.75247525,176,0.5,0.5,0,1,1,0,0,1,1,76,0.5
77,23.76237624,177,0.5,0.5,0,1,1,0,0,1,1,77,0.5
78,22.77227723,178,0.5,0.5,0,1,1,0,0,1,1,78,0.5
79,21.78217822,179,0.5,0.5,0,1,1,0,0,1,1,79,0.5
80,20.79207921,180,0.5,0.5,0,1,1,0,0,1,1,80,0.5
81,19.8019802,181,0.5,0.5,0,1,1,0,0,1,1,81,0.5
82,18.81188119,182,0.5,0.5,0,1,1,0,0,1,1,82,0.5
83,17.82178218,183,0.5,0.5,0,1,1,0,0,1,1,83,0.5
84,16.83168317,184,0.5,0.5,0,1,1,0,0,1,1,84,0.5
85,15.84158416,185,0.5,0.5,0,1,1,0,0,1,1,85,0.5
86,14.85148515,186,0.5,0.5,0,1,1,0,0,1,1,86,0.5
87,13.86138614,187,0.5,0.5,0,1,1,0,0,1,1,87,0.5
88,12.87128713,188,0.5,0.5,0,1,1,0,0,1,1,88,0.5
89,11.88118812,189,0.5,0.5,0,1,1,0,0,1,1,89,0.5
90,10.89108911,190,0.5,0.5,0,1,1,0,0,1,1,90,0.5
91,9.900990099,191,0.5,0.5,0,1,1,0,0,1,1,91,0.5
92,8.910891089,192,0.5,0.5,0,1,1,0,0,1,1,92,0.5
93,7.920792079,193,0.5,0.5,0,1,1,0,0,1,1,93,0.5
94,6.930693069,194,0.5,0.5,0,1,1,0,0,1,1,94,0.5
95,5.940594059,195,0.5,0.5,0,1,1,0,0,1,1,95,0.5
96,4.95049505,196,0.5,0.5,0,1,1,0,0,1,1,96,0.5
97,3.96039604,197,0.5,0.5,0,1,1,0,0,1,1,97,0.5
98,2.97029703,198,0.5,0.5,0,1,1,0,0,1,1,98,0.5
99,1.98019802,199,0.5,0.5,0,1,1,0,0,1,1,99,0.5
100,0.9900990099,200,0.5,0.5,0,1,1,0,0,1,1,100,0.5
101,100,100,0.5,0.5,0,1,1,0,1,0,0,0,0.5544444444
102,98.90268379,101,0.5,0.5,0,1,1,0,1,0,1,1,0.5544444444
103,97.80536758,102,0.5,0.5,0,1,1,0,1,0,1,2,0.5544444444
104,96.70805137,103,0.5,0.5,0,1,1,0,1,0,1,3,0.5544444444
105,95.61073516,104,0.5,0.5,0,1,1,0,1,0,1,4,0.5544444444
106,94.51341895,105,0.5,0.5,0,1,1,0,1,0,1,5,0.5544444444
107,93.41610274,106,0.5,0.5,0,1,1,0,1,0,1,6,0.5544444444
108,92.31878653,107,0.5,0.5,0,1,1,0,1,0,1,7,0.5544444444
109,91.22147032,108,0.5,0.5,0,1,1,0,1,0,1,8,0.5544444444
110,90.12415411,109,0.5,0.5,0,1,1,0,1,0,1,9,0.5544444444
111,89.0268379,110,0.5,0.5,0,1,1,0,1,0,1,10,0.5544444444
112,87.92952169,111,0.5,0.5,0,1,1,0,1,0,1,11,0.5544444444
113,86.83220548,112,0.5,0.5,0,1,1,0,1,0,1,12,0.5544444444
114,85.73488927,113,0.5,0.5,0,1,1,0,1,0,1,13,0.5544444444
115,84.63757306,114,0.5,0.5,0,1,1,0,1,0,1,14,0.5544444444
116,83.54025685,115,0.5,0.5,0,1,1,0,1,0,1,15,0.5544444444
117,82.44294065,116,0.5,0.5,0,1,1,0,1,0,1,16,0.5544444444
118,81.34562444,117,0.5,0.5,0,1,1,0,1,0,1,17,0.5544444444
119,80.24830823,118,0.5,0.5,0,1,1,0,1,0,1,18,0.5544444444
120,79.15099202,119,0.5,0.5,0,1,1,0,1,0,1,19,0.5544444444
121,78.05367581,120,0.5,0.5,0,1,1,0,1,0,1,20,0.5544444444
122,76.9563596,121,0.5,0.5,0,1,1,0,1,0,1,21,0.5544444444
123,75.85904339,122,0.5,0.5,0,1,1,0,1,0,1,22,0.5544444444
124,74.76172718,123,0.5,0.5,0,1,1,0,1,0,1,23,0.5544444444
125,73.66441097,124,0.5,0.5,0,1,1,0,1,0,1,24,0.5544444444
126,72.56709476,125,0.5,0.5,0,1,1,0,1,0,1,25,0.5544444444
127,71.46977855,126,0.5,0.5,0,1,1,0,1,0,1,26,0.5544444444
128,70.37246234,127,0.5,0.5,0,1,1,0,1,0,1,27,0.5544444444
129,69.27514613,128,0.5,0.5,0,1,1,0,1,0,1,28,0.5544444444
130,68.17782992,129,0.5,0.5,0,1,1,0,1,0,1,29,0.5544444444
131,67.08051371,130,0.5,0.5,0,1,1,0,1,0,1,30,0.5544444444
132,65.9831975,131,0.5,0.5,0,1,1,0,1,0,1,31,0.5544444444
133,64.88588129,132,0.5,0.5,0,1,1,0,1,0,1,32,0.5544444444
134,63.78856508,133,0.5,0.5,0,1,1,0,1,0,1,33,0.5544444444
135,62.69124887,134,0.5,0.5,0,1,1,0,1,0,1,34,0.5544444444
136,61.59393266,135,0.5,0.5,0,1,1,0,1,0,1,35,0.5544444444
137,60.49661645,136,0.5,0.5,0,1,1,0,1,0,1,36,0.5544444444
138,59.39930024,137,0.5,0.5,0,1,1,0,1,0,1,37,0.5544444444
139,58.30198403,138,0.5,0.5,0,1,1,0,1,0,1,38,0.5544444444
140,57.20466782,139,0.5,0.5,0,1,1,0,1,0,1,39,0.5544444444
141,56.10735161,140,0.5,0.5,0,1,1,0,1,0,1,40,0.5544444444
142,55.0100354,141,0.5,0.5,0,1,1,0,1,0,1,41,0.5544444444
143,53.91271919,142,0.5,0.5,0,1,1,0,1,0,1,42,0.5544444444
144,52.81540298,143,0.5,0.5,0,1,1,0,1,0,1,43,0.5544444444
145,51.71808677,144,0.5,0.5,0,1,1,0,1,0,1,44,0.5544444444
146,50.62077056,145,0.5,0.5,0,1,1,0,1,0,1,45,0.5544444444
147,49.52345436,146,0.5,0.5,0,1,1,0,1,0,1,46,0.5544444444
148,48.42613815,147,0.5,0.5,0,1,1,0,1,0,1,47,0.5544444444
149,47.32882194,148,0.5,0.5,0,1,1,0,1,0,1,48,0.5544444444
150,46.23150573,149,0.5,0.5,0,1,1,0,1,0,1,49,0.5544444444
151,45.13418952,150,0.5,0.5,0,1,1,0,1,0,1,50,0.5544444444
152,44.03687331,151,0.5,0.5,0,1,1,0,1,0,1,51,0.5544444444
153,42.9395571,152,0.5,0.5,0,1,1,0,1,0,1,52,0.5544444444
154,41.84224089,153,0.5,0.5,0,1,1,0,1,0,1,53,0.5544444444
155,40.74492468,154,0.5,0.5,0,1,1,0,1,0,1,54,0.5544444444
156,39.64760847,155,0.5,0.5,0,1,1,0,1,0,1,55,0.5544444444
157,38.55029226,156,0.5,0.5,0,1,1,0,1,0,1,56,0.5544444444
158,37.45297605,157,0.5,0.5,0,1,1,0,1,0,1,57,0.5544444444
159,36.35565984,158,0.5,0.5,0,1,1,0,1,0,1,58,0.5544444444
160,35.25834363,159,0.5,0.5,0,1,1,0,1,0,1,59,0.5544444444
161,34.16102742,160,0.5,0.5,0,1,1,0,1,0,1,60,0.5544444444
162,33.06371121,161,0.5,0.5,0,1,1,0,1,0,1,61,0.5544444444
163,31.966395,162,0.5,0.5,0,1,1,0,1,0,1,62,0.5544444444
164,30.86907879,163,0.5,0.5,0,1,1,0,1,0,1,63,0.5544444444
165,29.77176258,164,0.5,0.5,0,1,1,0,1,0,1,64,0.5544444444
166,28.67444637,165,0.5,0.5,0,1,1,0,1,0,1,65,0.5544444444
167,27.57713016,166,0.5,0.5,0,1,1,0,1,0,1,66,0.5544444444
168,26.47981395,167,0.5,0.5,0,1,1,0,1,0,1,67,0.5544444444
169,25.38249774,168,0.5,0.5,0,1,1,0,1,0,1,68,0.5544444444
170,24.28518153,169,0.5,0.5,0,1,1,0,1,0,1,69,0.5544444444
171,23.18786532,170,0.5,0.5,0,1,1,0,1,0,1,70,0.5544444444
172,22.09054911,171,0.5,0.5,0,1,1,0,1,0,1,71,0.5544444444
173,20.9932329,172,0.5,0.5,0,1,1,0,1,0,1,72,0.5544444444
174,19.89591669,173,0.5,0.5,0,1,1,0,1,0,1,73,0.5544444444
175,18.79860048,174,0.5,0.5,0,1,1,0,1,0,1,74,0.5544444444
176,17.70128427,175,0.5,0.5,0,1,1,0,1,0,1,75,0.5544444444
177,16.60396807,176,0.5,0.5,0,1,1,0,1,0,1,76,0.5544444444
178,15.50665186,177,0.5,0.5,0,1,1,0,1,0,1,77,0.5544444444
179,14.40933565,178,0.5,0.5,0,1,1,0,1,0,1,78,0.5544444444
180,13.31201944,179,0.5,0.5,0,1,1,0,1,0,1,79,0.5544444444
181,12.21470323,180,0.5,0.5,0,1,1,0,1,0,1,80,0.5544444444
182,11.11738702,181,0.5,0.5,0,1,1,0,1,0,1,81,0.5544444444
183,10.02007081,182,0.5,0.5,0,1,1,0,1,0,1,82,0.5544444444
184,8.922754598,183,0.5,0.5,0,1,1,0,1,0,1,83,0.5544444444
185,7.825438388,184,0.5,0.5,0,1,1,0,1,0,1,84,0.5544444444
186,6.728122178,185,0.5,0.5,0,1,1,0,1,0,1,85,0.5544444444
187,5.630805969,186,0.5,0.5,0,1,1,0,1,0,1,86,0.5544444444
188,4.533489759,187,0.5,0.5,0,1,1,0,1,0,1,87,0.5544444444
189,3.436173549,188,0.5,0.5,0,1,1,0,1,0,1,88,0.5544444444
190,2.33885734,189,0.5,0.5,0,1,1,0,1,0,1,89,0.5544444444
191,1.24154113,190,0.5,0.5,0,1,1,0,1,0,1,90,0.5544444444
192,0.1442249202,191,0.5,0.5,0,1,1,0,1,0,1,91,0.5544444444
193,-0.9530912894,192,0.5,0.5,0,1,1,0,1,0,1,92,0.5544444444
194,-2.050407499,193,0.5,0.5,0,1,1,0,1,0,1,93,0.5544444444
195,-3.147723709,194,0.5,0.5,0,1,1,0,1,0,1,94,0.5544444444
196,-4.245039918,195,0.5,0.5,0,1,1,0,1,0,1,95,0.5544444444
197,-5.342356128,196,0.5,0.5,0,1,1,0,1,0,1,96,0.5544444444
198,-6.439672338,197,0.5,0.5,0,1,1,0,1,0,1,97,0.5544444444
199,-7.536988547,198,0.5,0.5,0,1,1,0,1,0,1,98,0.5544444444
200,-8.634304757,199,0.5,0.5,0,1,1,0,1,0,1,99,0.5544444444
201,-9.731620967,200,0.5,0.5,0,1,1,0,1,0,1,100,0.5544444444
202,100,100,0.5,0.5,0,1,1,0,2,0,0,0,0.6088888889
203,98.7955827,101,0.5,0.5,0,1,1,0,2,0,1,1,0.6088888889
204,97.59116539,102,0.5,0.5,0,1,1,0,2,0,1,2,0.6088888889
205,96.38674809,103,0.5,0.5,0,1,1,0,2,0,1,3,0.6088888889
206,95.18233078,104,0.5,0.5,0,1,1,0,2,0,1,4,0.6088888889
207,93.97791348,105,0.5,0.5,0,1,1,0,2,0,1,5,0.6088888889
208,92.77349617,106,0.5,0.5,0,1,1,0,2,0,1,6,0.6088888889
209,91.56907887,107,0.5,0.5,0,1,1,0,2,0,1,7,0.6088888889
210,90.36466156,108,0.5,0.5,0,1,1,0,2,0,1,8,0.6088888889
211,89.16024426,109,0.5,0.5,0,1,1,0,2,0,1,9,0.6088888889
212,87.95582695,110,0.5,0.5,0,1,1,0,2,0,1,10,0.6088888889
213,86.75140965,111,0.5,0.5,0,1,1,0,2,0,1,11,0.6088888889
214,85.54699234,112,0.5,0.5,0,1,1,0,2,0,1,12,0.6088888889
215,84.34257504,113,0.5,0.5,0,1,1,0,2,0,1,13,0.6088888889
216,83.13815774,114,0.5,0.5,0,1,1,0,2,0,1,14,0.6088888889
217,81.93374043,115,0.5,0.5,0,1,1,0,2,0,1,15,0.6088888889
218,80.72932313,116,0.5,0.5,0,1,1,0,2,0,1,16,0.6088888889
219,79.52490582,117,0.5,0.5,0,1,1,0,2,0,1,17,0.6088888889
220,78.32048852,118,0.5,0.5,0,1,1,0,2,0,1,18,0.6088888889
221,77.11607121,119,0.5,0.5,0,1,1,0,2,0,1,19,0.6088888889
222,75.91165391,120,0.5,0.5,0,1,1,0,2,0,1,20,0.6088888889
223,74.7072366,121,0.5,0.5,0,1,1,0,2,0,1,21,0.6088888889
224,73.5028193,122,0.5,0.5,0,1,1,0,2,0,1,22,0.6088888889
225,72.29840199,123,0.5,0.5,0,1,1,0,2,0,1,23,0.6088888889
226,71.09398469,124,0.5,0.5,0,1,1,0,2,0,1,24,0.6088888889
227,69.88956738,125,0.5,0.5,0,1,1,0,2,0,1,25,0.6088888889
228,68.68515008,126,0.5,0.5,0,1,1,0,2,0,1,26,0.6088888889
229,67.48073278,127,0.5,0.5,0,1,1,0,2,0,1,27,0.6088888889
230,66.27631547,128,0.5,0.5,0,1,1,0,2,0,1,28,0.6088888889
231,65.07189817,129,0.5,0.5,0,1,1,0,2,0,1,29,0.6088888889
232,63.86748086,130,0.5,0.5,0,1,1,0,2,0,1,30,0.6088888889
233,62.66306356,131,0.5,0.5,0,1,1,0,2,0,1,31,0.6088888889
234,61.45864625,132,0.5,0.5,0,1,1,0,2,0,1,32,0.6088888889
235,60.25422895,133,0.5,0.5,0,1,1,0,2,0,1,33,0.6088888889
236,59.04981164,134,0.5,0.5,0,1,1,0,2,0,1,34,0.6088888889
237,57.84539434,135,0.5,0.5,0,1,1,0,2,0,1,35,0.6088888889
238,56.64097703,136,0.5,0.5,0,1,1,0,2,0,1,36,0.6088888889
239,55.43655973,137,0.5,0.5,0,1,1,0,2,0,1,37,0.6088888889
240,54.23214243,138,0.5,0.5,0,1,1,0,2,0,1,38,0.6088888889
241,53.02772512,139,0.5,0.5,0,1,1,0,2,0,1,39,0.6088888889
242,51.82330782,140,0.5,0.5,0,1,1,0,2,0,1,40,0.6088888889
243,50.61889051,141,0.5,0.5,0,1,1,0,2,0,1,41,0.6088888889
244,49.41447321,142,0.5,0.5,0,1,1,0,2,0,1,42,0.6088888889
245,48.2100559,143,0.5,0.5,0,1,1,0,2,0,1,43,0.6088888889
246,47.0056386,144,0.5,0.5,0,1,1,0,2,0,1,44,0.6088888889
247,45.80122129,145,0.5,0.5,0,1,1,0,2,0,1,45,0.6088888889
248,44.59680399,146,0.5,0.5,0,1,1,0,2,0,1,46,0.6088888889
249,43.39238668,147,0.5,0.5,0,1,1,0,2,0,1,47,0.6088888889
250,42.18796938,148,0.5,0.5,0,1,1,0,2,0,1,48,0.6088888889
251,40.98355207,149,0.5,0.5,0,1,1,0,2,0,1,49,0.6088888889
252,39.77913477,150,0.5,0.5,0,1,1,0,2,0,1,50,0.6088888889
253,38.57471747,151,0.5,0.5,0,1,1,0,2,0,1,51,0.6088888889
254,37.37030016,152,0.5,0.5,0,1,1,0,2,0,1,52,0.6088888889
255,36.16588286,153,0.5,0.5,0,1,1,0,2,0,1,53,0.6088888889
256,34.96146555,154,0.5,0.5,0,1,1,0,2,0,1,54,0.6088888889
257,33.75704825,155,0.5,0.5,0,1,1,0,2,0,1,55,0.6088888889
258,32.55263094,156,0.5,0.5,0,1,1,0,2,0,1,56,0.6088888889
259,31.34821364,157,0.5,0.5,0,1,1,0,2,0,1,57,0.6088888889
260,30.14379633,158,0.5,0.5,0,1,1,0,2,0,1,58,0.6088888889
261,28.93937903,159,0.5,0.5,0,1,1,0,2,0,1,59,0.6088888889
262,27.73496172,160,0.5,0.5,0,1,1,0,2,0,1,60,0.6088888889
263,26.53054442,161,0.5,0.5,0,1,1,0,2,0,1,61,0.6088888889
264,25.32612711,162,0.5,0.5,0,1,1,0,2,0,1,62,0.6088888889
265,24.12170981,163,0.5,0.5,0,1,1,0,2,0,1,63,0.6088888889
266,22.91729251,164,0.5,0.5,0,1,1,0,2,0,1,64,0.6088888889
267,21.7128752,165,0.5,0.5,0,1,1,0,2,0,1,65,0.6088888889
268,20.5084579,166,0.5,0.5,0,1,1,0,2,0,1,66,0.6088888889
269,19.30404059,167,0.5,0.5,0,1,1,0,2,0,1,67,0.6088888889
270,18.09962329,168,0.5,0.5,0,1,1,0,2,0,1,68,0.6088888889
271,16.89520598,169,0.5,0.5,0,1,1,0,2,0,1,69,0.6088888889
272,15.69078868,170,0.5,0.5,0,1,1,0,2,0,1,70,0.6088888889
273,14.48637137,171,0.5,0.5,0,1,1,0,2,0,1,71,0.6088888889
274,13.28195407,172,0.5,0.5,0,1,1,0,2,0,1,72,0.6088888889
275,12.07753676,173,0.5,0.5,0,1,1,0,2,0,1,73,0.6088888889
276,10.87311946,174,0.5,0.5,0,1,1,0,2,0,1,74,0.6088888889
277,9.668702155,175,0.5,0.5,0,1,1,0,2,0,1,75,0.6088888889
278,8.46428485,176,0.5,0.5,0,1,1,0,2,0,1,76,0.6088888889
279,7.259867546,177,0.5,0.5,0,1,1,0,2,0,1,77,0.6088888889
280,6.055450241,178,0.5,0.5,0,1,1,0,2,0,1,78,0.6088888889
281,4.851032936,179,0.5,0.5,0,1,1,0,2,0,1,79,0.6088888889
282,3.646615632,180,0.5,0.5,0,1,1,0,2,0,1,80,0.6088888889
283,2.442198327,181,0.5,0.5,0,1,1,0,2,0,1,81,0.6088888889
284,1.237781023,182,0.5,0.5,0,1,1,0,2,0,1,82,0.6088888889
285,0.033363718,183,0.5,0.5,0,1,1,0,2,0,1,83,0.6088888889
286,-1.171053587,184,0.5,0.5,0,1,1,0,2,0,1,84,0.6088888889
287,-2.375470891,185,0.5,0.5,0,1,1,0,2,0,1,85,0.6088888889
288,-3.579888196,186,0.5,0.5,0,1,1,0,2,0,1,86,0.6088888889
289,-4.7843055,187,0.5,0.5,0,1,1,0,2,0,1,87,0.6088888889
290,-5.988722805,188,0.5,0.5,0,1,1,0,2,0,1,88,0.6088888889
291,-7.19314011,189,0.5,0.5,0,1,1,0,2,0,1,89,0.6088888889
292,-8.397557414,190,0.5,0.5,0,1,1,0,2,0,1,90,0.6088888889
293,-9.601974719,191,0.5,0.5,0,1,1,0,2,0,1,91,0.6088888889
294,-10.80639202,192,0.5,0.5,0,1,1,0,2,0,1,92,0.6088888889
295,-12.01080933,193,0.5,0.5,0,1,1,0,2,0,1,93,0.6088888889
296,-13.21522663,194,0.5,0.5,0,1,1,0,2,0,1,94,0.6088888889
297,-14.41964394,195,0.5,0.5,0,1,1,0,2,0,1,95,0.6088888889
298,-15.62406124,196,0.5,0.5,0,1,1,0,2,0,1,96,0.6088888889
299,-16.82847855,197,0.5,0.5,0,1,1,0,2,0,1,97,0.6088888889
300,-18.03289585,198,0.5,0.5,0,1,1,0,2,0,1,98,0.6088888889
301,-19.23731316,199,0.5,0.5,0,1,1,0,2,0,1,99,0.6088888889
302,-20.44173046,200,0.5,0.5,0,1,1,0,2,0,1,100,0.6088888889
303,100,100,0.5,0.5,0,1,1,0,3,0,0,0,0.6633333333
304,98.68859758,101,0.5,0.5,0,1,1,0,3,0,1,1,0.6633333333
305,97.37719516,102,0.5,0.5,0,1,1,0,3,0,1,2,0.6633333333
306,96.06579274,103,0.5,0.5,0,1,1,0,3,0,1,3,0.6633333333
307,94.75439032,104,0.5,0.5,0,1,1,0,3,0,1,4,0.6633333333
308,93.4429879,105,0.5,0.5,0,1,1,0,3,0,1,5,0.6633333333
309,92.13158548,106,0.5,0.5,0,1,1,0,3,0,1,6,0.6633333333
310,90.82018306,107,0.5,0.5,0,1,1,0,3,0,1,7,0.6633333333
311,89.50878064,108,0.5,0.5,0,1,1,0,3,0,1,8,0.6633333333
312,88.19737822,109,0.5,0.5,0,1,1,0,3,0,1,9,0.6633333333
313,86.8859758,110,0.5,0.5,0,1,1,0,3,0,1,10,0.6633333333
314,85.57457338,111,0.5,0.5,0,1,1,0,3,0,1,11,0.6633333333
315,84.26317095,112,0.5,0.5,0,1,1,0,3,0,1,12,0.6633333333
316,82.95176853,113,0.5,0.5,0,1,1,0,3,0,1,13,0.6633333333
317,81.64036611,114,0.5,0.5,0,1,1,0,3,0,1,14,0.6633333333
318,80.32896369,115,0.5,0.5,0,1,1,0,3,0,1,15,0.6633333333
319,79.01756127,116,0.5,0.5,0,1,1,0,3,0,1,16,0.6633333333
320,77.70615885,117,0.5,0.5,0,1,1,0,3,0,1,17,0.6633333333
321,76.39475643,118,0.5,0.5,0,1,1,0,3,0,1,18,0.6633333333
322,75.08335401,119,0.5,0.5,0,1,1,0,3,0,1,19,0.6633333333
323,73.77195159,120,0.5,0.5,0,1,1,0,3,0,1,20,0.6633333333
324,72.46054917,121,0.5,0.5,0,1,1,0,3,0,1,21,0.6633333333
325,71.14914675,122,0.5,0.5,0,1,1,0,3,0,1,22,0.6633333333
326,69.83774433,123,0.5,0.5,0,1,1,0,3,0,1,23,0.6633333333
327,68.52634191,124,0.5,0.5,0,1,1,0,3,0,1,24,0.6633333333
328,67.21493949,125,0.5,0.5,0,1,1,0,3,0,1,25,0.6633333333
329,65.90353707,126,0.5,0.5,0,1,1,0,3,0,1,26,0.6633333333
330,64.59213465,127,0.5,0.5,0,1,1,0,3,0,1,27,0.6633333333
331,63.28073223,128,0.5,0.5,0,1,1,0,3,0,1,28,0.6633333333
332,61.96932981,129,0.5,0.5,0,1,1,0,3,0,1,29,0.6633333333
333,60.65792739,130,0.5,0.5,0,1,1,0,3,0,1,30,0.6633333333
334,59.34652497,131,0.5,0.5,0,1,1,0,3,0,1,31,0.6633333333
335,58.03512255,132,0.5,0.5,0,1,1,0,3,0,1,32,0.6633333333
336,56.72372013,133,0.5,0.5,0,1,1,0,3,0,1,33,0.6633333333
337,55.41231771,134,0.5,0.5,0,1,1,0,3,0,1,34,0.6633333333
338,54.10091528,135,0.5,0.5,0,1,1,0,3,0,1,35,0.6633333333
339,52.78951286,136,0.5,0.5,0,1,1,0,3,0,1,36,0.6633333333
340,51.47811044,137,0.5,0.5,0,1,1,0,3,0,1,37,0.6633333333
341,50.16670802,138,0.5,0.5,0,1,1,0,3,0,1,38,0.6633333333
342,48.8553056,139,0.5,0.5,0,1,1,0,3,0,1,39,0.6633333333
343,47.54390318,140,0.5,0.5,0,1,1,0,3,0,1,40,0.6633333333
344,46.23250076,141,0.5,0.5,0,1,1,0,3,0,1,41,0.6633333333
345,44.92109834,142,0.5,0.5,0,1,1,0,3,0,1,42,0.6633333333
346,43.60969592,143,0.5,0.5,0,1,1,0,3,0,1,43,0.6633333333
347,42.2982935,144,0.5,0.5,0,1,1,0,3,0,1,44,0.6633333333
348,40.98689108,145,0.5,0.5,0,1,1,0,3,0,1,45,0.6633333333
349,39.67548866,146,0.5,0.5,0,1,1,0,3,0,1,46,0.6633333333
350,38.36408624,147,0.5,0.5,0,1,1,0,3,0,1,47,0.6633333333
351,37.05268382,148,0.5,0.5,0,1,1,0,3,0,1,48,0.6633333333
352,35.7412814,149,0.5,0.5,0,1,1,0,3,0,1,49,0.6633333333
353,34.42987898,150,0.5,0.5,0,1,1,0,3,0,1,50,0.6633333333
354,33.11847656,151,0.5,0.5,0,1,1,0,3,0,1,51,0.6633333333
355,31.80707414,152,0.5,0.5,0,1,1,0,3,0,1,52,0.6633333333
356,30.49567172,153,0.5,0.5,0,1,1,0,3,0,1,53,0.6633333333
357,29.1842693,154,0.5,0.5,0,1,1,0,3,0,1,54,0.6633333333
358,27.87286688,155,0.5,0.5,0,1,1,0,3,0,1,55,0.6633333333
359,26.56146446,156,0.5,0.5,0,1,1,0,3,0,1,56,0.6633333333
360,25.25006204,157,0.5,0.5,0,1,1,0,3,0,1,57,0.6633333333
361,23.93865961,158,0.5,0.5,0,1,1,0,3,0,1,58,0.6633333333
362,22.62725719,159,0.5,0.5,0,1,1,0,3,0,1,59,0.6633333333
363,21.31585477,160,0.5,0.5,0,1,1,0,3,0,1,60,0.6633333333
364,20.00445235,161,0.5,0.5,0,1,1,0,3,0,1,61,0.6633333333
365,18.69304993,162,0.5,0.5,0,1,1,0,3,0,1,62,0.6633333333
366,17.38164751,163,0.5,0.5,0,1,1,0,3,0,1,63,0.6633333333
367,16.07024509,164,0.5,0.5,0,1,1,0,3,0,1,64,0.6633333333
368,14.75884267,165,0.5,0.5,0,1,1,0,3,0,1,65,0.6633333333
369,13.44744025,166,0.5,0.5,0,1,1,0,3,0,1,66,0.6633333333
370,12.13603783,167,0.5,0.5,0,1,1,0,3,0,1,67,0.6633333333
371,10.82463541,168,0.5,0.5,0,1,1,0,3,0,1,68,0.6633333333
372,9.51323299,169,0.5,0.5,0,1,1,0,3,0,1,69,0.6633333333
373,8.20183057,170,0.5,0.5,0,1,1,0,3,0,1,70,0.6633333333
374,6.890428149,171,0.5,0.5,0,1,1,0,3,0,1,71,0.6633333333
375,5.579025729,172,0.5,0.5,0,1,1,0,3,0,1,72,0.6633333333
376,4.267623308,173,0.5,0.5,0,1,1,0,3,0,1,73,0.6633333333
377,2.956220888,174,0.5,0.5,0,1,1,0,3,0,1,74,0.6633333333
378,1.644818467,175,0.5,0.5,0,1,1,0,3,0,1,75,0.6633333333
379,0.333416047,176,0.5,0.5,0,1,1,0,3,0,1,76,0.6633333333
380,-0.9779863734,177,0.5,0.5,0,1,1,0,3,0,1,77,0.6633333333
381,-2.289388794,178,0.5,0.5,0,1,1,0,3,0,1,78,0.6633333333
382,-3.600791214,179,0.5,0.5,0,1,1,0,3,0,1,79,0.6633333333
383,-4.912193635,180,0.5,0.5,0,1,1,0,3,0,1,80,0.6633333333
384,-6.223596055,181,0.5,0.5,0,1,1,0,3,0,1,81,0.6633333333
385,-7.534998476,182,0.5,0.5,0,1,1,0,3,0,1,82,0.6633333333
386,-8.846400896,183,0.5,0.5,0,1,1,0,3,0,1,83,0.6633333333
387,-10.15780332,184,0.5,0.5,0,1,1,0,3,0,1,84,0.6633333333
388,-11.46920574,185,0.5,0.5,0,1,1,0,3,0,1,85,0.6633333333
389,-12.78060816,186,0.5,0.5,0,1,1,0,3,0,1,86,0.6633333333
390,-14.09201058,187,0.5,0.5,0,1,1,0,3,0,1,87,0.6633333333
391,-15.403413,188,0.5,0.5,0,1,1,0,3,0,1,88,0.6633333333
392,-16.71481542,189,0.5,0.5,0,1,1,0,3,0,1,89,0.6633333333
393,-18.02621784,190,0.5,0.5,0,1,1,0,3,0,1,90,0.6633333333
394,-19.33762026,191,0.5,0.5,0,1,1,0,3,0,1,91,0.6633333333
395,-20.64902268,192,0.5,0.5,0,1,1,0,3,0,1,92,0.6633333333
396,-21.9604251,193,0.5,0.5,0,1,1,0,3,0,1,93,0.6633333333
397,-23.27182752,194,0.5,0.5,0,1,1,0,3,0,1,94,0.6633333333
398,-24.58322994,195,0.5,0.5,0,1,1,0,3,0,1,95,0.6633333333
399,-25.89463236,196,0.5,0.5,0,1,1,0,3,0,1,96,0.6633333333
400,-27.20603478,197,0.5,0.5,0,1,1,0,3,0,1,97,0.6633333333
401,-28.5174372,198,0.5,0.5,0,1,1,0,3,0,1,98,0.6633333333
402,-29.82883962,199,0.5,0.5,0,1,1,0,3,0,1,99,0.6633333333
403,-31.14024204,200,0.5,0.5,0,1,1,0,3,0,1,100,0.6633333333
404,100,100,0.5,0.5,0,1,1,0,4,0,0,0,0.7177777778
405,98.58172832,101,0.5,0.5,0,1,1,0,4,0,1,1,0.7177777778
406,97.16345663,102,0.5,0.5,0,1,1,0,4,0,1,2,0.7177777778
407,95.74518495,103,0.5,0.5,0,1,1,0,4,0,1,3,0.7177777778
408,94.32691327,104,0.5,0.5,0,1,1,0,4,0,1,4,0.7177777778
409,92.90864159,105,0.5,0.5,0,1,1,0,4,0,1,5,0.7177777778
410,91.4903699,106,0.5,0.5,0,1,1,0,4,0,1,6,0.7177777778
411,90.07209822,107,0.5,0.5,0,1,1,0,4,0,1,7,0.7177777778
412,88.65382654,108,0.5,0.5,0,1,1,0,4,0,1,8,0.7177777778
413,87.23555486,109,0.5,0.5,0,1,1,0,4,0,1,9,0.7177777778
414,85.81728317,110,0.5,0.5,0,1,1,0,4,0,1,10,0.7177777778
415,84.39901149,111,0.5,0.5,0,1,1,0,4,0,1,11,0.7177777778
416,82.98073981,112,0.5,0.5,0,1,1,0,4,0,1,12,0.7177777778
417,81.56246812,113,0.5,0.5,0,1,1,0,4,0,1,13,0.7177777778
418,80.14419644,114,0.5,0.5,0,1,1,0,4,0,1,14,0.7177777778
419,78.72592476,115,0.5,0.5,0,1,1,0,4,0,1,15,0.7177777778
420,77.30765308,116,0.5,0.5,0,1,1,0,4,0,1,16,0.7177777778
421,75.88938139,117,0.5,0.5,0,1,1,0,4,0,1,17,0.7177777778
422,74.47110971,118,0.5,0.5,0,1,1,0,4,0,1,18,0.7177777778
423,73.05283803,119,0.5,0.5,0,1,1,0,4,0,1,19,0.7177777778
424,71.63456634,120,0.5,0.5,0,1,1,0,4,0,1,20,0.7177777778
425,70.21629466,121,0.5,0.5,0,1,1,0,4,0,1,21,0.7177777778
426,68.79802298,122,0.5,0.5,0,1,1,0,4,0,1,22,0.7177777778
427,67.3797513,123,0.5,0.5,0,1,1,0,4,0,1,23,0.7177777778
428,65.96147961,124,0.5,0.5,0,1,1,0,4,0,1,24,0.7177777778
429,64.54320793,125,0.5,0.5,0,1,1,0,4,0,1,25,0.7177777778
430,63.12493625,126,0.5,0.5,0,1,1,0,4,0,1,26,0.7177777778
431,61.70666457,127,0.5,0.5,0,1,1,0,4,0,1,27,0.7177777778
432,60.28839288,128,0.5,0.5,0,1,1,0,4,0,1,28,0.7177777778
433,58.8701212,129,0.5,0.5,0,1,1,0,4,0,1,29,0.7177777778
434,57.45184952,130,0.5,0.5,0,1,1,0,4,0,1,30,0.7177777778
435,56.03357783,131,0.5,0.5,0,1,1,0,4,0,1,31,0.7177777778
436,54.61530615,132,0.5,0.5,0,1,1,0,4,0,1,32,0.7177777778
437,53.19703447,133,0.5,0.5,0,1,1,0,4,0,1,33,0.7177777778
438,51.77876279,134,0.5,0.5,0,1,1,0,4,0,1,34,0.7177777778
439,50.3604911,135,0.5,0.5,0,1,1,0,4,0,1,35,0.7177777778
440,48.94221942,136,0.5,0.5,0,1,1,0,4,0,1,36,0.7177777778
441,47.52394774,137,0.5,0.5,0,1,1,0,4,0,1,37,0.7177777778
442,46.10567606,138,0.5,0.5,0,1,1,0,4,0,1,38,0.7177777778
443,44.68740437,139,0.5,0.5,0,1,1,0,4,0,1,39,0.7177777778
444,43.26913269,140,0.5,0.5,0,1,1,0,4,0,1,40,0.7177777778
445,41.85086101,141,0.5,0.5,0,1,1,0,4,0,1,41,0.7177777778
446,40.43258932,142,0.5,0.5,0,1,1,0,4,0,1,42,0.7177777778
447,39.01431764,143,0.5,0.5,0,1,1,0,4,0,1,43,0.7177777778
448,37.59604596,144,0.5,0.5,0,1,1,0,4,0,1,44,0.7177777778
449,36.17777428,145,0.5,0.5,0,1,1,0,4,0,1,45,0.7177777778
450,34.75950259,146,0.5,0.5,0,1,1,0,4,0,1,46,0.7177777778
451,33.34123091,147,0.5,0.5,0,1,1,0,4,0,1,47,0.7177777778
452,31.92295923,148,0.5,0.5,0,1,1,0,4,0,1,48,0.7177777778
453,30.50468754,149,0.5,0.5,0,1,1,0,4,0,1,49,0.7177777778
454,29.08641586,150,0.5,0.5,0,1,1,0,4,0,1,50,0.7177777778
455,27.66814418,151,0.5,0.5,0,1,1,0,4,0,1,51,0.7177777778
456,26.2498725,152,0.5,0.5,0,1,1,0,4,0,1,52,0.7177777778
457,24.83160081,153,0.5,0.5,0,1,1,0,4,0,1,53,0.7177777778
458,23.41332913,154,0.5,0.5,0,1,1,0,4,0,1,54,0.7177777778
459,21.99505745,155,0.5,0.5,0,1,1,0,4,0,1,55,0.7177777778
460,20.57678577,156,0.5,0.5,0,1,1,0,4,0,1,56,0.7177777778
461,19.15851408,157,0.5,0.5,0,1,1,0,4,0,1,57,0.7177777778
462,17.7402424,158,0.5,0.5,0,1,1,0,4,0,1,58,0.7177777778
463,16.32197072,159,0.5,0.5,0,1,1,0,4,0,1,59,0.7177777778
464,14.90369903,160,0.5,0.5,0,1,1,0,4,0,1,60,0.7177777778
465,13.48542735,161,0.5,0.5,0,1,1,0,4,0,1,61,0.7177777778
466,12.06715567,162,0.5,0.5,0,1,1,0,4,0,1,62,0.7177777778
467,10.64888399,163,0.5,0.5,0,1,1,0,4,0,1,63,0.7177777778
468,9.230612304,164,0.5,0.5,0,1,1,0,4,0,1,64,0.7177777778
469,7.812340621,165,0.5,0.5,0,1,1,0,4,0,1,65,0.7177777778
470,6.394068938,166,0.5,0.5,0,1,1,0,4,0,1,66,0.7177777778
471,4.975797255,167,0.5,0.5,0,1,1,0,4,0,1,67,0.7177777778
472,3.557525573,168,0.5,0.5,0,1,1,0,4,0,1,68,0.7177777778
473,2.13925389,169,0.5,0.5,0,1,1,0,4,0,1,69,0.7177777778
474,0.7209822071,170,0.5,0.5,0,1,1,0,4,0,1,70,0.7177777778
475,-0.6972894757,171,0.5,0.5,0,1,1,0,4,0,1,71,0.7177777778
476,-2.115561158,172,0.5,0.5,0,1,1,0,4,0,1,72,0.7177777778
477,-3.533832841,173,0.5,0.5,0,1,1,0,4,0,1,73,0.7177777778
478,-4.952104524,174,0.5,0.5,0,1,1,0,4,0,1,74,0.7177777778
479,-6.370376207,175,0.5,0.5,0,1,1,0,4,0,1,75,0.7177777778
480,-7.788647889,176,0.5,0.5,0,1,1,0,4,0,1,76,0.7177777778
481,-9.206919572,177,0.5,0.5,0,1,1,0,4,0,1,77,0.7177777778
482,-10.62519125,178,0.5,0.5,0,1,1,0,4,0,1,78,0.7177777778
483,-12.04346294,179,0.5,0.5,0,1,1,0,4,0,1,79,0.7177777778
484,-13.46173462,180,0.5,0.5,0,1,1,0,4,0,1,80,0.7177777778
485,-14.8800063,181,0.5,0.5,0,1,1,0,4,0,1,81,0.7177777778
486,-16.29827799,182,0.5,0.5,0,1,1,0,4,0,1,82,0.7177777778
487,-17.71654967,183,0.5,0.5,0,1,1,0,4,0,1,83,0.7177777778
488,-19.13482135,184,0.5,0.5,0,1,1,0,4,0,1,84,0.7177777778
489,-20.55309303,185,0.5,0.5,0,1,1,0,4,0,1,85,0.7177777778
490,-21.97136472,186,0.5,0.5,0,1,1,0,4,0,1,86,0.7177777778
491,-23.3896364,187,0.5,0.5,0,1,1,0,4,0,1,87,0.7177777778
492,-24.80790808,188,0.5,0.5,0,1,1,0,4,0,1,88,0.7177777778
493,-26.22617977,189,0.5,0.5,0,1,1,0,4,0,1,89,0.7177777778
494,-27.64445145,190,0.5,0.5,0,1,1,0,4,0,1,90,0.7177777778
495,-29.06272313,191,0.5,0.5,0,1,1,0,4,0,1,91,0.7177777778
496,-30.48099481,192,0.5,0.5,0,1,1,0,4,0,1,92,0.7177777778
497,-31.8992665,193,0.5,0.5,0,1,1,0,4,0,1,93,0.7177777778
498,-33.31753818,194,0.5,0.5,0,1,1,0,4,0,1,94,0.7177777778
499,-34.73580986,195,0.5,0.5,0,1,1,0,4,0,1,95,0.7177777778
500,-36.15408154,196,0.5,0.5,0,1,1,0,4,0,1,96,0.7177777778
501,-37.57235323,197,0.5,0.5,0,1,1,0,4,0,1,97,0.7177777778
502,-38.99062491,198,0.5,0.5,0,1,1,0,4,0,1,98,0.7177777778
503,-40.40889659,199,0.5,0.5,0,1,1,0,4,0,1,99,0.7177777778
504,-41.82716828,200,0.5,0.5,0,1,1,0,4,0,1,100,0.7177777778
505,100,100,0.5,0.5,0,1,1,0,5,0,0,0,0.7722222222
506,98.47497478,101,0.5,0.5,0,1,1,0,5,0,1,1,0.7722222222
507,96.94994957,102,0.5,0.5,0,1,1,0,5,0,1,2,0.7722222222
508,95.42492435,103,0.5,0.5,0,1,1,0,5,0,1,3,0.7722222222
509,93.89989913,104,0.5,0.5,0,1,1,0,5,0,1,4,0.7722222222
510,92.37487391,105,0.5,0.5,0,1,1,0,5,0,1,5,0.7722222222
511,90.8498487,106,0.5,0.5,0,1,1,0,5,0,1,6,0.7722222222
512,89.32482348,107,0.5,0.5,0,1,1,0,5,0,1,7,0.7722222222
513,87.79979826,108,0.5,0.5,0,1,1,0,5,0,1,8,0.7722222222
514,86.27477305,109,0.5,0.5,0,1,1,0,5,0,1,9,0.7722222222
515,84.74974783,110,0.5,0.5,0,1,1,0,5,0,1,10,0.7722222222
516,83.22472261,111,0.5,0.5,0,1,1,0,5,0,1,11,0.7722222222
517,81.6996974,112,0.5,0.5,0,1,1,0,5,0,1,12,0.7722222222
518,80.17467218,113,0.5,0.5,0,1,1,0,5,0,1,13,0.7722222222
519,78.64964696,114,0.5,0.5,0,1,1,0,5,0,1,14,0.7722222222
520,77.12462174,115,0.5,0.5,0,1,1,0,5,0,1,15,0.7722222222
521,75.59959653,116,0.5,0.5,0,1,1,0,5,0,1,16,0.7722222222
522,74.07457131,117,0.5,0.5,0,1,1,0,5,0,1,17,0.7722222222
523,72.54954609,118,0.5,0.5,0,1,1,0,5,0,1,18,0.7722222222
524,71.02452088,119,0.5,0.5,0,1,1,0,5,0,1,19,0.7722222222
525,69.49949566,120,0.5,0.5,0,1,1,0,5,0,1,20,0.7722222222
526,67.97447044,121,0.5,0.5,0,1,1,0,5,0,1,21,0.7722222222
527,66.44944523,122,0.5,0.5,0,1,1,0,5,0,1,22,0.7722222222
528,64.92442001,123,0.5,0.5,0,1,1,0,5,0,1,23,0.7722222222
529,63.39939479,124,0.5,0.5,0,1,1,0,5,0,1,24,0.7722222222
530,61.87436957,125,0.5,0.5,0,1,1,0,5,0,1,25,0.7722222222
531,60.34934436,126,0.5,0.5,0,1,1,0,5,0,1,26,0.7722222222
532,58.82431914,127,0.5,0.5,0,1,1,0,5,0,1,27,0.7722222222
533,57.29929392,128,0.5,0.5,0,1,1,0,5,0,1,28,0.7722222222
534,55.77426871,129,0.5,0.5,0,1,1,0,5,0,1,29,0.7722222222
535,54.24924349,130,0.5,0.5,0,1,1,0,5,0,1,30,0.7722222222
536,52.72421827,131,0.5,0.5,0,1,1,0,5,0,1,31,0.7722222222
537,51.19919306,132,0.5,0.5,0,1,1,0,5,0,1,32,0.7722222222
538,49.67416784,133,0.5,0.5,0,1,1,0,5,0,1,33,0.7722222222
539,48.14914262,134,0.5,0.5,0,1,1,0,5,0,1,34,0.7722222222
540,46.6241174,135,0.5,0.5,0,1,1,0,5,0,1,35,0.7722222222
541,45.09909219,136,0.5,0.5,0,1,1,0,5,0,1,36,0.7722222222
542,43.57406697,137,0.5,0.5,0,1,1,0,5,0,1,37,0.7722222222
543,42.04904175,138,0.5,0.5,0,1,1,0,5,0,1,38,0.7722222222
544,40.52401654,139,0.5,0.5,0,1,1,0,5,0,1,39,0.7722222222
545,38.99899132,140,0.5,0.5,0,1,1,0,5,0,1,40,0.7722222222
546,37.4739661,141,0.5,0.5,0,1,1,0,5,0,1,41,0.7722222222
547,35.94894088,142,0.5,0.5,0,1,1,0,5,0,1,42,0.7722222222
548,34.42391567,143,0.5,0.5,0,1,1,0,5,0,1,43,0.7722222222
549,32.89889045,144,0.5,0.5,0,1,1,0,5,0,1,44,0.7722222222
550,31.37386523,145,0.5,0.5,0,1,1,0,5,0,1,45,0.7722222222
551,29.84884002,146,0.5,0.5,0,1,1,0,5,0,1,46,0.7722222222
552,28.3238148,147,0.5,0.5,0,1,1,0,5,0,1,47,0.7722222222
553,26.79878958,148,0.5,0.5,0,1,1,0,5,0,1,48,0.7722222222
554,25.27376437,149,0.5,0.5,0,1,1,0,5,0,1,49,0.7722222222
555,23.74873915,150,0.5,0.5,0,1,1,0,5,0,1,50,0.7722222222
556,22.22371393,151,0.5,0.5,0,1,1,0,5,0,1,51,0.7722222222
557,20.69868871,152,0.5,0.5,0,1,1,0,5,0,1,52,0.7722222222
558,19.1736635,153,0.5,0.5,0,1,1,0,5,0,1,53,0.7722222222
559,17.64863828,154,0.5,0.5,0,1,1,0,5,0,1,54,0.7722222222
560,16.12361306,155,0.5,0.5,0,1,1,0,5,0,1,55,0.7722222222
561,14.59858785,156,0.5,0.5,0,1,1,0,5,0,1,56,0.7722222222
562,13.07356263,157,0.5,0.5,0,1,1,0,5,0,1,57,0.7722222222
563,11.54853741,158,0.5,0.5,0,1,1,0,5,0,1,58,0.7722222222
564,10.0235122,159,0.5,0.5,0,1,1,0,5,0,1,59,0.7722222222
565,8.498486978,160,0.5,0.5,0,1,1,0,5,0,1,60,0.7722222222
566,6.973461761,161,0.5,0.5,0,1,1,0,5,0,1,61,0.7722222222
567,5.448436544,162,0.5,0.5,0,1,1,0,5,0,1,62,0.7722222222
568,3.923411327,163,0.5,0.5,0,1,1,0,5,0,1,63,0.7722222222
569,2.39838611,164,0.5,0.5,0,1,1,0,5,0,1,64,0.7722222222
570,0.8733608933,165,0.5,0.5,0,1,1,0,5,0,1,65,0.7722222222
571,-0.6516643237,166,0.5,0.5,0,1,1,0,5,0,1,66,0.7722222222
572,-2.176689541,167,0.5,0.5,0,1,1,0,5,0,1,67,0.7722222222
573,-3.701714758,168,0.5,0.5,0,1,1,0,5,0,1,68,0.7722222222
574,-5.226739975,169,0.5,0.5,0,1,1,0,5,0,1,69,0.7722222222
575,-6.751765192,170,0.5,0.5,0,1,1,0,5,0,1,70,0.7722222222
576,-8.276790409,171,0.5,0.5,0,1,1,0,5,0,1,71,0.7722222222
577,-9.801815626,172,0.5,0.5,0,1,1,0,5,0,1,72,0.7722222222
578,-11.32684084,173,0.5,0.5,0,1,1,0,5,0,1,73,0.7722222222
579,-12.85186606,174,0.5,0.5,0,1,1,0,5,0,1,74,0.7722222222
580,-14.37689128,175,0.5,0.5,0,1,1,0,5,0,1,75,0.7722222222
581,-15.90191649,176,0.5,0.5,0,1,1,0,5,0,1,76,0.7722222222
582,-17.42694171,177,0.5,0.5,0,1,1,0,5,0,1,77,0.7722222222
583,-18.95196693,178,0.5,0.5,0,1,1,0,5,0,1,78,0.7722222222
584,-20.47699215,179,0.5,0.5,0,1,1,0,5,0,1,79,0.7722222222
585,-22.00201736,180,0.5,0.5,0,1,1,0,5,0,1,80,0.7722222222
586,-23.52704258,181,0.5,0.5,0,1,1,0,5,0,1,81,0.7722222222
587,-25.0520678,182,0.5,0.5,0,1,1,0,5,0,1,82,0.7722222222
588,-26.57709301,183,0.5,0.5,0,1,1,0,5,0,1,83,0.7722222222
589,-28.10211823,184,0.5,0.5,0,1,1,0,5,0,1,84,0.7722222222
590,-29.62714345,185,0.5,0.5,0,1,1,0,5,0,1,85,0.7722222222
591,-31.15216866,186,0.5,0.5,0,1,1,0,5,0,1,86,0.7722222222
592,-32.67719388,187,0.5,0.5,0,1,1,0,5,0,1,87,0.7722222222
593,-34.2022191,188,0.5,0.5,0,1,1,0,5,0,1,88,0.7722222222
594,-35.72724432,189,0.5,0.5,0,1,1,0,5,0,1,89,0.7722222222
595,-37.25226953,190,0.5,0.5,0,1,1,0,5,0,1,90,0.7722222222
596,-38.77729475,191,0.5,0.5,0,1,1,0,5,0,1,91,0.7722222222
597,-40.30231997,192,0.5,0.5,0,1,1,0,5,0,1,92,0.7722222222
598,-41.82734518,193,0.5,0.5,0,1,1,0,5,0,1,93,0.7722222222
599,-43.3523704,194,0.5,0.5,0,1,1,0,5,0,1,94,0.7722222222
600,-44.87739562,195,0.5,0.5,0,1,1,0,5,0,1,95,0.7722222222
601,-46.40242083,196,0.5,0.5,0,1,1,0,5,0,1,96,0.7722222222
602,-47.92744605,197,0.5,0.5,0,1,1,0,5,0,1,97,0.7722222222
603,-49.45247127,198,0.5,0.5,0,1,1,0,5,0,1,98,0.7722222222
604,-50.97749649,199,0.5,0.5,0,1,1,0,5,0,1,99,0.7722222222
605,-52.5025217,200,0.5,0.5,0,1,1,0,5,0,1,100,0.7722222222
606,100,100,0.5,0.5,0,1,1,0,6,0,0,0,0.8266666667
607,98.36833685,101,0.5,0.5,0,1,1,0,6,0,1,1,0.8266666667
608,96.7366737,102,0.5,0.5,0,1,1,0,6,0,1,2,0.8266666667
609,95.10501055,103,0.5,0.5,0,1,1,0,6,0,1,3,0.8266666667
610,93.47334741,104,0.5,0.5,0,1,1,0,6,0,1,4,0.8266666667
611,91.84168426,105,0.5,0.5,0,1,1,0,6,0,1,5,0.8266666667
612,90.21002111,106,0.5,0.5,0,1,1,0,6,0,1,6,0.8266666667
613,88.57835796,107,0.5,0.5,0,1,1,0,6,0,1,7,0.8266666667
614,86.94669481,108,0.5,0.5,0,1,1,0,6,0,1,8,0.8266666667
615,85.31503166,109,0.5,0.5,0,1,1,0,6,0,1,9,0.8266666667
616,83.68336851,110,0.5,0.5,0,1,1,0,6,0,1,10,0.8266666667
617,82.05170537,111,0.5,0.5,0,1,1,0,6,0,1,11,0.8266666667
618,80.42004222,112,0.5,0.5,0,1,1,0,6,0,1,12,0.8266666667
619,78.78837907,113,0.5,0.5,0,1,1,0,6,0,1,13,0.8266666667
620,77.15671592,114,0.5,0.5,0,1,1,0,6,0,1,14,0.8266666667
621,75.52505277,115,0.5,0.5,0,1,1,0,6,0,1,15,0.8266666667
622,73.89338962,116,0.5,0.5,0,1,1,0,6,0,1,16,0.8266666667
623,72.26172647,117,0.5,0.5,0,1,1,0,6,0,1,17,0.8266666667
624,70.63006333,118,0.5,0.5,0,1,1,0,6,0,1,18,0.8266666667
625,68.99840018,119,0.5,0.5,0,1,1,0,6,0,1,19,0.8266666667
626,67.36673703,120,0.5,0.5,0,1,1,0,6,0,1,20,0.8266666667
627,65.73507388,121,0.5,0.5,0,1,1,0,6,0,1,21,0.8266666667
628,64.10341073,122,0.5,0.5,0,1,1,0,6,0,1,22,0.8266666667
629,62.47174758,123,0.5,0.5,0,1,1,0,6,0,1,23,0.8266666667
630,60.84008443,124,0.5,0.5,0,1,1,0,6,0,1,24,0.8266666667
631,59.20842129,125,0.5,0.5,0,1,1,0,6,0,1,25,0.8266666667
632,57.57675814,126,0.5,0.5,0,1,1,0,6,0,1,26,0.8266666667
633,55.94509499,127,0.5,0.5,0,1,1,0,6,0,1,27,0.8266666667
634,54.31343184,128,0.5,0.5,0,1,1,0,6,0,1,28,0.8266666667
635,52.68176869,129,0.5,0.5,0,1,1,0,6,0,1,29,0.8266666667
636,51.05010554,130,0.5,0.5,0,1,1,0,6,0,1,30,0.8266666667
637,49.41844239,131,0.5,0.5,0,1,1,0,6,0,1,31,0.8266666667
638,47.78677925,132,0.5,0.5,0,1,1,0,6,0,1,32,0.8266666667
639,46.1551161,133,0.5,0.5,0,1,1,0,6,0,1,33,0.8266666667
640,44.52345295,134,0.5,0.5,0,1,1,0,6,0,1,34,0.8266666667
641,42.8917898,135,0.5,0.5,0,1,1,0,6,0,1,35,0.8266666667
642,41.26012665,136,0.5,0.5,0,1,1,0,6,0,1,36,0.8266666667
643,39.6284635,137,0.5,0.5,0,1,1,0,6,0,1,37,0.8266666667
644,37.99680035,138,0.5,0.5,0,1,1,0,6,0,1,38,0.8266666667
645,36.36513721,139,0.5,0.5,0,1,1,0,6,0,1,39,0.8266666667
646,34.73347406,140,0.5,0.5,0,1,1,0,6,0,1,40,0.8266666667
647,33.10181091,141,0.5,0.5,0,1,1,0,6,0,1,41,0.8266666667
648,31.47014776,142,0.5,0.5,0,1,1,0,6,0,1,42,0.8266666667
649,29.83848461,143,0.5,0.5,0,1,1,0,6,0,1,43,0.8266666667
650,28.20682146,144,0.5,0.5,0,1,1,0,6,0,1,44,0.8266666667
651,26.57515831,145,0.5,0.5,0,1,1,0,6,0,1,45,0.8266666667
652,24.94349517,146,0.5,0.5,0,1,1,0,6,0,1,46,0.8266666667
653,23.31183202,147,0.5,0.5,0,1,1,0,6,0,1,47,0.8266666667
654,21.68016887,148,0.5,0.5,0,1,1,0,6,0,1,48,0.8266666667
655,20.04850572,149,0.5,0.5,0,1,1,0,6,0,1,49,0.8266666667
656,18.41684257,150,0.5,0.5,0,1,1,0,6,0,1,50,0.8266666667
657,16.78517942,151,0.5,0.5,0,1,1,0,6,0,1,51,0.8266666667
658,15.15351627,152,0.5,0.5,0,1,1,0,6,0,1,52,0.8266666667
659,13.52185313,153,0.5,0.5,0,1,1,0,6,0,1,53,0.8266666667
660,11.89018998,154,0.5,0.5,0,1,1,0,6,0,1,54,0.8266666667
661,10.25852683,155,0.5,0.5,0,1,1,0,6,0,1,55,0.8266666667
662,8.62686368,156,0.5,0.5,0,1,1,0,6,0,1,56,0.8266666667
663,6.995200532,157,0.5,0.5,0,1,1,0,6,0,1,57,0.8266666667
664,5.363537383,158,0.5,0.5,0,1,1,0,6,0,1,58,0.8266666667
665,3.731874235,159,0.5,0.5,0,1,1,0,6,0,1,59,0.8266666667
666,2.100211086,160,0.5,0.5,0,1,1,0,6,0,1,60,0.8266666667
667,0.4685479376,161,0.5,0.5,0,1,1,0,6,0,1,61,0.8266666667
668,-1.163115211,162,0.5,0.5,0,1,1,0,6,0,1,62,0.8266666667
669,-2.794778359,163,0.5,0.5,0,1,1,0,6,0,1,63,0.8266666667
670,-4.426441508,164,0.5,0.5,0,1,1,0,6,0,1,64,0.8266666667
671,-6.058104657,165,0.5,0.5,0,1,1,0,6,0,1,65,0.8266666667
672,-7.689767805,166,0.5,0.5,0,1,1,0,6,0,1,66,0.8266666667
673,-9.321430954,167,0.5,0.5,0,1,1,0,6,0,1,67,0.8266666667
674,-10.9530941,168,0.5,0.5,0,1,1,0,6,0,1,68,0.8266666667
675,-12.58475725,169,0.5,0.5,0,1,1,0,6,0,1,69,0.8266666667
676,-14.2164204,170,0.5,0.5,0,1,1,0,6,0,1,70,0.8266666667
677,-15.84808355,171,0.5,0.5,0,1,1,0,6,0,1,71,0.8266666667
678,-17.4797467,172,0.5,0.5,0,1,1,0,6,0,1,72,0.8266666667
679,-19.11140985,173,0.5,0.5,0,1,1,0,6,0,1,73,0.8266666667
680,-20.74307299,174,0.5,0.5,0,1,1,0,6,0,1,74,0.8266666667
681,-22.37473614,175,0.5,0.5,0,1,1,0,6,0,1,75,0.8266666667
682,-24.00639929,176,0.5,0.5,0,1,1,0,6,0,1,76,0.8266666667
683,-25.63806244,177,0.5,0.5,0,1,1,0,6,0,1,77,0.8266666667
684,-27.26972559,178,0.5,0.5,0,1,1,0,6,0,1,78,0.8266666667
685,-28.90138874,179,0.5,0.5,0,1,1,0,6,0,1,79,0.8266666667
686,-30.53305189,180,0.5,0.5,0,1,1,0,6,0,1,80,0.8266666667
687,-32.16471503,181,0.5,0.5,0,1,1,0,6,0,1,81,0.8266666667
688,-33.79637818,182,0.5,0.5,0,1,1,0,6,0,1,82,0.8266666667
689,-35.42804133,183,0.5,0.5,0,1,1,0,6,0,1,83,0.8266666667
690,-37.05970448,184,0.5,0.5,0,1,1,0,6,0,1,84,0.8266666667
691,-38.69136763,185,0.5,0.5,0,1,1,0,6,0,1,85,0.8266666667
692,-40.32303078,186,0.5,0.5,0,1,1,0,6,0,1,86,0.8266666667
693,-41.95469392,187,0.5,0.5,0,1,1,0,6,0,1,87,0.8266666667
694,-43.58635707,188,0.5,0.5,0,1,1,0,6,0,1,88,0.8266666667
695,-45.21802022,189,0.5,0.5,0,1,1,0,6,0,1,89,0.8266666667
696,-46.84968337,190,0.5,0.5,0,1,1,0,6,0,1,90,0.8266666667
697,-48.48134652,191,0.5,0.5,0,1,1,0,6,0,1,91,0.8266666667
698,-50.11300967,192,0.5,0.5,0,1,1,0,6,0,1,92,0.8266666667
699,-51.74467282,193,0.5,0.5,0,1,1,0,6,0,1,93,0.8266666667
700,-53.37633596,194,0.5,0.5,0,1,1,0,6,0,1,94,0.8266666667
701,-55.00799911,195,0.5,0.5,0,1,1,0,6,0,1,95,0.8266666667
702,-56.63966226,196,0.5,0.5,0,1,1,0,6,0,1,96,0.8266666667
703,-58.27132541,197,0.5,0.5,0,1,1,0,6,0,1,97,0.8266666667
704,-59.90298856,198,0.5,0.5,0,1,1,0,6,0,1,98,0.8266666667
705,-61.53465171,199,0.5,0.5,0,1,1,0,6,0,1,99,0.8266666667
706,-63.16631486,200,0.5,0.5,0,1,1,0,6,0,1,100,0.8266666667
707,100,100,0.5,0.5,0,1,1,0,7,0,0,0,0.8811111111
708,98.2618144,101,0.5,0.5,0,1,1,0,7,0,1,1,0.8811111111
709,96.52362879,102,0.5,0.5,0,1,1,0,7,0,1,2,0.8811111111
710,94.78544319,103,0.5,0.5,0,1,1,0,7,0,1,3,0.8811111111
711,93.04725759,104,0.5,0.5,0,1,1,0,7,0,1,4,0.8811111111
712,91.30907199,105,0.5,0.5,0,1,1,0,7,0,1,5,0.8811111111
713,89.57088638,106,0.5,0.5,0,1,1,0,7,0,1,6,0.8811111111
714,87.83270078,107,0.5,0.5,0,1,1,0,7,0,1,7,0.8811111111
715,86.09451518,108,0.5,0.5,0,1,1,0,7,0,1,8,0.8811111111
716,84.35632958,109,0.5,0.5,0,1,1,0,7,0,1,9,0.8811111111
717,82.61814397,110,0.5,0.5,0,1,1,0,7,0,1,10,0.8811111111
718,80.87995837,111,0.5,0.5,0,1,1,0,7,0,1,11,0.8811111111
719,79.14177277,112,0.5,0.5,0,1,1,0,7,0,1,12,0.8811111111
720,77.40358717,113,0.5,0.5,0,1,1,0,7,0,1,13,0.8811111111
721,75.66540156,114,0.5,0.5,0,1,1,0,7,0,1,14,0.8811111111
722,73.92721596,115,0.5,0.5,0,1,1,0,7,0,1,15,0.8811111111
723,72.18903036,116,0.5,0.5,0,1,1,0,7,0,1,16,0.8811111111
724,70.45084476,117,0.5,0.5,0,1,1,0,7,0,1,17,0.8811111111
725,68.71265915,118,0.5,0.5,0,1,1,0,7,0,1,18,0.8811111111
726,66.97447355,119,0.5,0.5,0,1,1,0,7,0,1,19,0.8811111111
727,65.23628795,120,0.5,0.5,0,1,1,0,7,0,1,20,0.8811111111
728,63.49810235,121,0.5,0.5,0,1,1,0,7,0,1,21,0.8811111111
729,61.75991674,122,0.5,0.5,0,1,1,0,7,0,1,22,0.8811111111
730,60.02173114,123,0.5,0.5,0,1,1,0,7,0,1,23,0.8811111111
731,58.28354554,124,0.5,0.5,0,1,1,0,7,0,1,24,0.8811111111
732,56.54535994,125,0.5,0.5,0,1,1,0,7,0,1,25,0.8811111111
733,54.80717433,126,0.5,0.5,0,1,1,0,7,0,1,26,0.8811111111
734,53.06898873,127,0.5,0.5,0,1,1,0,7,0,1,27,0.8811111111
735,51.33080313,128,0.5,0.5,0,1,1,0,7,0,1,28,0.8811111111
736,49.59261753,129,0.5,0.5,0,1,1,0,7,0,1,29,0.8811111111
737,47.85443192,130,0.5,0.5,0,1,1,0,7,0,1,30,0.8811111111
738,46.11624632,131,0.5,0.5,0,1,1,0,7,0,1,31,0.8811111111
739,44.37806072,132,0.5,0.5,0,1,1,0,7,0,1,32,0.8811111111
740,42.63987512,133,0.5,0.5,0,1,1,0,7,0,1,33,0.8811111111
741,40.90168951,134,0.5,0.5,0,1,1,0,7,0,1,34,0.8811111111
742,39.16350391,135,0.5,0.5,0,1,1,0,7,0,1,35,0.8811111111
743,37.42531831,136,0.5,0.5,0,1,1,0,7,0,1,36,0.8811111111
744,35.68713271,137,0.5,0.5,0,1,1,0,7,0,1,37,0.8811111111
745,33.9489471,138,0.5,0.5,0,1,1,0,7,0,1,38,0.8811111111
746,32.2107615,139,0.5,0.5,0,1,1,0,7,0,1,39,0.8811111111
747,30.4725759,140,0.5,0.5,0,1,1,0,7,0,1,40,0.8811111111
748,28.7343903,141,0.5,0.5,0,1,1,0,7,0,1,41,0.8811111111
749,26.99620469,142,0.5,0.5,0,1,1,0,7,0,1,42,0.8811111111
750,25.25801909,143,0.5,0.5,0,1,1,0,7,0,1,43,0.8811111111
751,23.51983349,144,0.5,0.5,0,1,1,0,7,0,1,44,0.8811111111
752,21.78164789,145,0.5,0.5,0,1,1,0,7,0,1,45,0.8811111111
753,20.04346228,146,0.5,0.5,0,1,1,0,7,0,1,46,0.8811111111
754,18.30527668,147,0.5,0.5,0,1,1,0,7,0,1,47,0.8811111111
755,16.56709108,148,0.5,0.5,0,1,1,0,7,0,1,48,0.8811111111
756,14.82890547,149,0.5,0.5,0,1,1,0,7,0,1,49,0.8811111111
757,13.09071987,150,0.5,0.5,0,1,1,0,7,0,1,50,0.8811111111
758,11.35253427,151,0.5,0.5,0,1,1,0,7,0,1,51,0.8811111111
759,9.614348667,152,0.5,0.5,0,1,1,0,7,0,1,52,0.8811111111
760,7.876163065,153,0.5,0.5,0,1,1,0,7,0,1,53,0.8811111111
761,6.137977462,154,0.5,0.5,0,1,1,0,7,0,1,54,0.8811111111
762,4.399791859,155,0.5,0.5,0,1,1,0,7,0,1,55,0.8811111111
763,2.661606257,156,0.5,0.5,0,1,1,0,7,0,1,56,0.8811111111
764,0.9234206544,157,0.5,0.5,0,1,1,0,7,0,1,57,0.8811111111
765,-0.8147649482,158,0.5,0.5,0,1,1,0,7,0,1,58,0.8811111111
766,-2.552950551,159,0.5,0.5,0,1,1,0,7,0,1,59,0.8811111111
767,-4.291136153,160,0.5,0.5,0,1,1,0,7,0,1,60,0.8811111111
768,-6.029321756,161,0.5,0.5,0,1,1,0,7,0,1,61,0.8811111111
769,-7.767507358,162,0.5,0.5,0,1,1,0,7,0,1,62,0.8811111111
770,-9.505692961,163,0.5,0.5,0,1,1,0,7,0,1,63,0.8811111111
771,-11.24387856,164,0.5,0.5,0,1,1,0,7,0,1,64,0.8811111111
772,-12.98206417,165,0.5,0.5,0,1,1,0,7,0,1,65,0.8811111111
773,-14.72024977,166,0.5,0.5,0,1,1,0,7,0,1,66,0.8811111111
774,-16.45843537,167,0.5,0.5,0,1,1,0,7,0,1,67,0.8811111111
775,-18.19662097,168,0.5,0.5,0,1,1,0,7,0,1,68,0.8811111111
776,-19.93480658,169,0.5,0.5,0,1,1,0,7,0,1,69,0.8811111111
777,-21.67299218,170,0.5,0.5,0,1,1,0,7,0,1,70,0.8811111111
778,-23.41117778,171,0.5,0.5,0,1,1,0,7,0,1,71,0.8811111111
779,-25.14936338,172,0.5,0.5,0,1,1,0,7,0,1,72,0.8811111111
780,-26.88754899,173,0.5,0.5,0,1,1,0,7,0,1,73,0.8811111111
781,-28.62573459,174,0.5,0.5,0,1,1,0,7,0,1,74,0.8811111111
782,-30.36392019,175,0.5,0.5,0,1,1,0,7,0,1,75,0.8811111111
783,-32.10210579,176,0.5,0.5,0,1,1,0,7,0,1,76,0.8811111111
784,-33.8402914,177,0.5,0.5,0,1,1,0,7,0,1,77,0.8811111111
785,-35.578477,178,0.5,0.5,0,1,1,0,7,0,1,78,0.8811111111
786,-37.3166626,179,0.5,0.5,0,1,1,0,7,0,1,79,0.8811111111
787,-39.0548482,180,0.5,0.5,0,1,1,0,7,0,1,80,0.8811111111
788,-40.79303381,181,0.5,0.5,0,1,1,0,7,0,1,81,0.8811111111
789,-42.53121941,182,0.5,0.5,0,1,1,0,7,0,1,82,0.8811111111
790,-44.26940501,183,0.5,0.5,0,1,1,0,7,0,1,83,0.8811111111
791,-46.00759061,184,0.5,0.5,0,1,1,0,7,0,1,84,0.8811111111
792,-47.74577622,185,0.5,0.5,0,1,1,0,7,0,1,85,0.8811111111
793,-49.48396182,186,0.5,0.5,0,1,1,0,7,0,1,86,0.8811111111
794,-51.22214742,187,0.5,0.5,0,1,1,0,7,0,1,87,0.8811111111
795,-52.96033302,188,0.5,0.5,0,1,1,0,7,0,1,88,0.8811111111
796,-54.69851863,189,0.5,0.5,0,1,1,0,7,0,1,89,0.8811111111
797,-56.43670423,190,0.5,0.5,0,1,1,0,7,0,1,90,0.8811111111
798,-58.17488983,191,0.5,0.5,0,1,1,0,7,0,1,91,0.8811111111
799,-59.91307544,192,0.5,0.5,0,1,1,0,7,0,1,92,0.8811111111
800,-61.65126104,193,0.5,0.5,0,1,1,0,7,0,1,93,0.8811111111
801,-63.38944664,194,0.5,0.5,0,1,1,0,7,0,1,94,0.8811111111
802,-65.12763224,195,0.5,0.5,0,1,1,0,7,0,1,95,0.8811111111
803,-66.86581785,196,0.5,0.5,0,1,1,0,7,0,1,96,0.8811111111
804,-68.60400345,197,0.5,0.5,0,1,1,0,7,0,1,97,0.8811111111
805,-70.34218905,198,0.5,0.5,0,1,1,0,7,0,1,98,0.8811111111
806,-72.08037465,199,0.5,0.5,0,1,1,0,7,0,1,99,0.8811111111
807,-73.81856026,200,0.5,0.5,0,1,1,0,7,0,1,100,0.8811111111
808,100,100,0.5,0.5,0,1,1,0,8,0,0,0,0.9355555556
809,98.1554073,101,0.5,0.5,0,1,1,0,8,0,1,1,0.9355555556
810,96.31081459,102,0.5,0.5,0,1,1,0,8,0,1,2,0.9355555556
811,94.46622189,103,0.5,0.5,0,1,1,0,8,0,1,3,0.9355555556
812,92.62162918,104,0.5,0.5,0,1,1,0,8,0,1,4,0.9355555556
813,90.77703648,105,0.5,0.5,0,1,1,0,8,0,1,5,0.9355555556
814,88.93244378,106,0.5,0.5,0,1,1,0,8,0,1,6,0.9355555556
815,87.08785107,107,0.5,0.5,0,1,1,0,8,0,1,7,0.9355555556
816,85.24325837,108,0.5,0.5,0,1,1,0,8,0,1,8,0.9355555556
817,83.39866566,109,0.5,0.5,0,1,1,0,8,0,1,9,0.9355555556
818,81.55407296,110,0.5,0.5,0,1,1,0,8,0,1,10,0.9355555556
819,79.70948026,111,0.5,0.5,0,1,1,0,8,0,1,11,0.9355555556
820,77.86488755,112,0.5,0.5,0,1,1,0,8,0,1,12,0.9355555556
821,76.02029485,113,0.5,0.5,0,1,1,0,8,0,1,13,0.9355555556
822,74.17570214,114,0.5,0.5,0,1,1,0,8,0,1,14,0.9355555556
823,72.33110944,115,0.5,0.5,0,1,1,0,8,0,1,15,0.9355555556
824,70.48651674,116,0.5,0.5,0,1,1,0,8,0,1,16,0.9355555556
825,68.64192403,117,0.5,0.5,0,1,1,0,8,0,1,17,0.9355555556
826,66.79733133,118,0.5,0.5,0,1,1,0,8,0,1,18,0.9355555556
827,64.95273862,119,0.5,0.5,0,1,1,0,8,0,1,19,0.9355555556
828,63.10814592,120,0.5,0.5,0,1,1,0,8,0,1,20,0.9355555556
829,61.26355321,121,0.5,0.5,0,1,1,0,8,0,1,21,0.9355555556
830,59.41896051,122,0.5,0.5,0,1,1,0,8,0,1,22,0.9355555556
831,57.57436781,123,0.5,0.5,0,1,1,0,8,0,1,23,0.9355555556
832,55.7297751,124,0.5,0.5,0,1,1,0,8,0,1,24,0.9355555556
833,53.8851824,125,0.5,0.5,0,1,1,0,8,0,1,25,0.9355555556
834,52.04058969,126,0.5,0.5,0,1,1,0,8,0,1,26,0.9355555556
835,50.19599699,127,0.5,0.5,0,1,1,0,8,0,1,27,0.9355555556
836,48.35140429,128,0.5,0.5,0,1,1,0,8,0,1,28,0.9355555556
837,46.50681158,129,0.5,0.5,0,1,1,0,8,0,1,29,0.9355555556
838,44.66221888,130,0.5,0.5,0,1,1,0,8,0,1,30,0.9355555556
839,42.81762617,131,0.5,0.5,0,1,1,0,8,0,1,31,0.9355555556
840,40.97303347,132,0.5,0.5,0,1,1,0,8,0,1,32,0.9355555556
841,39.12844077,133,0.5,0.5,0,1,1,0,8,0,1,33,0.9355555556
842,37.28384806,134,0.5,0.5,0,1,1,0,8,0,1,34,0.9355555556
843,35.43925536,135,0.5,0.5,0,1,1,0,8,0,1,35,0.9355555556
844,33.59466265,136,0.5,0.5,0,1,1,0,8,0,1,36,0.9355555556
845,31.75006995,137,0.5,0.5,0,1,1,0,8,0,1,37,0.9355555556
846,29.90547725,138,0.5,0.5,0,1,1,0,8,0,1,38,0.9355555556
847,28.06088454,139,0.5,0.5,0,1,1,0,8,0,1,39,0.9355555556
848,26.21629184,140,0.5,0.5,0,1,1,0,8,0,1,40,0.9355555556
849,24.37169913,141,0.5,0.5,0,1,1,0,8,0,1,41,0.9355555556
850,22.52710643,142,0.5,0.5,0,1,1,0,8,0,1,42,0.9355555556
851,20.68251373,143,0.5,0.5,0,1,1,0,8,0,1,43,0.9355555556
852,18.83792102,144,0.5,0.5,0,1,1,0,8,0,1,44,0.9355555556
853,16.99332832,145,0.5,0.5,0,1,1,0,8,0,1,45,0.9355555556
854,15.14873561,146,0.5,0.5,0,1,1,0,8,0,1,46,0.9355555556
855,13.30414291,147,0.5,0.5,0,1,1,0,8,0,1,47,0.9355555556
856,11.45955021,148,0.5,0.5,0,1,1,0,8,0,1,48,0.9355555556
857,9.614957502,149,0.5,0.5,0,1,1,0,8,0,1,49,0.9355555556
858,7.770364798,150,0.5,0.5,0,1,1,0,8,0,1,50,0.9355555556
859,5.925772093,151,0.5,0.5,0,1,1,0,8,0,1,51,0.9355555556
860,4.081179389,152,0.5,0.5,0,1,1,0,8,0,1,52,0.9355555556
861,2.236586685,153,0.5,0.5,0,1,1,0,8,0,1,53,0.9355555556
862,0.3919939813,154,0.5,0.5,0,1,1,0,8,0,1,54,0.9355555556
863,-1.452598723,155,0.5,0.5,0,1,1,0,8,0,1,55,0.9355555556
864,-3.297191427,156,0.5,0.5,0,1,1,0,8,0,1,56,0.9355555556
865,-5.141784131,157,0.5,0.5,0,1,1,0,8,0,1,57,0.9355555556
866,-6.986376835,158,0.5,0.5,0,1,1,0,8,0,1,58,0.9355555556
867,-8.830969539,159,0.5,0.5,0,1,1,0,8,0,1,59,0.9355555556
868,-10.67556224,160,0.5,0.5,0,1,1,0,8,0,1,60,0.9355555556
869,-12.52015495,161,0.5,0.5,0,1,1,0,8,0,1,61,0.9355555556
870,-14.36474765,162,0.5,0.5,0,1,1,0,8,0,1,62,0.9355555556
871,-16.20934036,163,0.5,0.5,0,1,1,0,8,0,1,63,0.9355555556
872,-18.05393306,164,0.5,0.5,0,1,1,0,8,0,1,64,0.9355555556
873,-19.89852576,165,0.5,0.5,0,1,1,0,8,0,1,65,0.9355555556
874,-21.74311847,166,0.5,0.5,0,1,1,0,8,0,1,66,0.9355555556
875,-23.58771117,167,0.5,0.5,0,1,1,0,8,0,1,67,0.9355555556
876,-25.43230388,168,0.5,0.5,0,1,1,0,8,0,1,68,0.9355555556
877,-27.27689658,169,0.5,0.5,0,1,1,0,8,0,1,69,0.9355555556
878,-29.12148928,170,0.5,0.5,0,1,1,0,8,0,1,70,0.9355555556
879,-30.96608199,171,0.5,0.5,0,1,1,0,8,0,1,71,0.9355555556
880,-32.81067469,172,0.5,0.5,0,1,1,0,8,0,1,72,0.9355555556
881,-34.6552674,173,0.5,0.5,0,1,1,0,8,0,1,73,0.9355555556
882,-36.4998601,174,0.5,0.5,0,1,1,0,8,0,1,74,0.9355555556
883,-38.3444528,175,0.5,0.5,0,1,1,0,8,0,1,75,0.9355555556
884,-40.18904551,176,0.5,0.5,0,1,1,0,8,0,1,76,0.9355555556
885,-42.03363821,177,0.5,0.5,0,1,1,0,8,0,1,77,0.9355555556
886,-43.87823092,178,0.5,0.5,0,1,1,0,8,0,1,78,0.9355555556
887,-45.72282362,179,0.5,0.5,0,1,1,0,8,0,1,79,0.9355555556
888,-47.56741632,180,0.5,0.5,0,1,1,0,8,0,1,80,0.9355555556
889,-49.41200903,181,0.5,0.5,0,1,1,0,8,0,1,81,0.9355555556
890,-51.25660173,182,0.5,0.5,0,1,1,0,8,0,1,82,0.9355555556
891,-53.10119444,183,0.5,0.5,0,1,1,0,8,0,1,83,0.9355555556
892,-54.94578714,184,0.5,0.5,0,1,1,0,8,0,1,84,0.9355555556
893,-56.79037984,185,0.5,0.5,0,1,1,0,8,0,1,85,0.9355555556
894,-58.63497255,186,0.5,0.5,0,1,1,0,8,0,1,86,0.9355555556
895,-60.47956525,187,0.5,0.5,0,1,1,0,8,0,1,87,0.9355555556
896,-62.32415796,188,0.5,0.5,0,1,1,0,8,0,1,88,0.9355555556
897,-64.16875066,189,0.5,0.5,0,1,1,0,8,0,1,89,0.9355555556
898,-66.01334336,190,0.5,0.5,0,1,1,0,8,0,1,90,0.9355555556
899,-67.85793607,191,0.5,0.5,0,1,1,0,8,0,1,91,0.9355555556
900,-69.70252877,192,0.5,0.5,0,1,1,0,8,0,1,92,0.9355555556
901,-71.54712148,193,0.5,0.5,0,1,1,0,8,0,1,93,0.9355555556
902,-73.39171418,194,0.5,0.5,0,1,1,0,8,0,1,94,0.9355555556
903,-75.23630688,195,0.5,0.5,0,1,1,0,8,0,1,95,0.9355555556
904,-77.08089959,196,0.5,0.5,0,1,1,0,8,0,1,96,0.9355555556
905,-78.92549229,197,0.5,0.5,0,1,1,0,8,0,1,97,0.9355555556
906,-80.770085,198,0.5,0.5,0,1,1,0,8,0,1,98,0.9355555556
907,-82.6146777,199,0.5,0.5,0,1,1,0,8,0,1,99,0.9355555556
908,-84.4592704,200,0.5,0.5,0,1,1,0,8,0,1,100,0.9355555556
909,100,100,0.5,0.5,0,1,1,0,9,0,0,0,0.99
910,98.04911542,101,0.5,0.5,0,1,1,0,9,0,1,1,0.99
911,96.09823084,102,0.5,0.5,0,1,1,0,9,0,1,2,0.99
912,94.14734627,103,0.5,0.5,0,1,1,0,9,0,1,3,0.99
913,92.19646169,104,0.5,0.5,0,1,1,0,9,0,1,4,0.99
914,90.24557711,105,0.5,0.5,0,1,1,0,9,0,1,5,0.99
915,88.29469253,106,0.5,0.5,0,1,1,0,9,0,1,6,0.99
916,86.34380795,107,0.5,0.5,0,1,1,0,9,0,1,7,0.99
917,84.39292338,108,0.5,0.5,0,1,1,0,9,0,1,8,0.99
918,82.4420388,109,0.5,0.5,0,1,1,0,9,0,1,9,0.99
919,80.49115422,110,0.5,0.5,0,1,1,0,9,0,1,10,0.99
920,78.54026964,111,0.5,0.5,0,1,1,0,9,0,1,11,0.99
921,76.58938506,112,0.5,0.5,0,1,1,0,9,0,1,12,0.99
922,74.63850049,113,0.5,0.5,0,1,1,0,9,0,1,13,0.99
923,72.68761591,114,0.5,0.5,0,1,1,0,9,0,1,14,0.99
924,70.73673133,115,0.5,0.5,0,1,1,0,9,0,1,15,0.99
925,68.78584675,116,0.5,0.5,0,1,1,0,9,0,1,16,0.99
926,66.83496217,117,0.5,0.5,0,1,1,0,9,0,1,17,0.99
927,64.8840776,118,0.5,0.5,0,1,1,0,9,0,1,18,0.99
928,62.93319302,119,0.5,0.5,0,1,1,0,9,0,1,19,0.99
929,60.98230844,120,0.5,0.5,0,1,1,0,9,0,1,20,0.99
930,59.03142386,121,0.5,0.5,0,1,1,0,9,0,1,21,0.99
931,57.08053928,122,0.5,0.5,0,1,1,0,9,0,1,22,0.99
932,55.12965471,123,0.5,0.5,0,1,1,0,9,0,1,23,0.99
933,53.17877013,124,0.5,0.5,0,1,1,0,9,0,1,24,0.99
934,51.22788555,125,0.5,0.5,0,1,1,0,9,0,1,25,0.99
935,49.27700097,126,0.5,0.5,0,1,1,0,9,0,1,26,0.99
936,47.32611639,127,0.5,0.5,0,1,1,0,9,0,1,27,0.99
937,45.37523182,128,0.5,0.5,0,1,1,0,9,0,1,28,0.99
938,43.42434724,129,0.5,0.5,0,1,1,0,9,0,1,29,0.99
939,41.47346266,130,0.5,0.5,0,1,1,0,9,0,1,30,0.99
940,39.52257808,131,0.5,0.5,0,1,1,0,9,0,1,31,0.99
941,37.57169351,132,0.5,0.5,0,1,1,0,9,0,1,32,0.99
942,35.62080893,133,0.5,0.5,0,1,1,0,9,0,1,33,0.99
943,33.66992435,134,0.5,0.5,0,1,1,0,9,0,1,34,0.99
944,31.71903977,135,0.5,0.5,0,1,1,0,9,0,1,35,0.99
945,29.76815519,136,0.5,0.5,0,1,1,0,9,0,1,36,0.99
946,27.81727062,137,0.5,0.5,0,1,1,0,9,0,1,37,0.99
947,25.86638604,138,0.5,0.5,0,1,1,0,9,0,1,38,0.99
948,23.91550146,139,0.5,0.5,0,1,1,0,9,0,1,39,0.99
949,21.96461688,140,0.5,0.5,0,1,1,0,9,0,1,40,0.99
950,20.0137323,141,0.5,0.5,0,1,1,0,9,0,1,41,0.99
951,18.06284773,142,0.5,0.5,0,1,1,0,9,0,1,42,0.99
952,16.11196315,143,0.5,0.5,0,1,1,0,9,0,1,43,0.99
953,14.16107857,144,0.5,0.5,0,1,1,0,9,0,1,44,0.99
954,12.21019399,145,0.5,0.5,0,1,1,0,9,0,1,45,0.99
955,10.25930941,146,0.5,0.5,0,1,1,0,9,0,1,46,0.99
956,8.308424836,147,0.5,0.5,0,1,1,0,9,0,1,47,0.99
957,6.357540258,148,0.5,0.5,0,1,1,0,9,0,1,48,0.99
958,4.40665568,149,0.5,0.5,0,1,1,0,9,0,1,49,0.99
959,2.455771102,150,0.5,0.5,0,1,1,0,9,0,1,50,0.99
960,0.5048865239,151,0.5,0.5,0,1,1,0,9,0,1,51,0.99
961,-1.445998054,152,0.5,0.5,0,1,1,0,9,0,1,52,0.99
962,-3.396882632,153,0.5,0.5,0,1,1,0,9,0,1,53,0.99
963,-5.34776721,154,0.5,0.5,0,1,1,0,9,0,1,54,0.99
964,-7.298651788,155,0.5,0.5,0,1,1,0,9,0,1,55,0.99
965,-9.249536366,156,0.5,0.5,0,1,1,0,9,0,1,56,0.99
966,-11.20042094,157,0.5,0.5,0,1,1,0,9,0,1,57,0.99
967,-13.15130552,158,0.5,0.5,0,1,1,0,9,0,1,58,0.99
968,-15.1021901,159,0.5,0.5,0,1,1,0,9,0,1,59,0.99
969,-17.05307468,160,0.5,0.5,0,1,1,0,9,0,1,60,0.99
970,-19.00395926,161,0.5,0.5,0,1,1,0,9,0,1,61,0.99
971,-20.95484383,162,0.5,0.5,0,1,1,0,9,0,1,62,0.99
972,-22.90572841,163,0.5,0.5,0,1,1,0,9,0,1,63,0.99
973,-24.85661299,164,0.5,0.5,0,1,1,0,9,0,1,64,0.99
974,-26.80749757,165,0.5,0.5,0,1,1,0,9,0,1,65,0.99
975,-28.75838215,166,0.5,0.5,0,1,1,0,9,0,1,66,0.99
976,-30.70926672,167,0.5,0.5,0,1,1,0,9,0,1,67,0.99
977,-32.6601513,168,0.5,0.5,0,1,1,0,9,0,1,68,0.99
978,-34.61103588,169,0.5,0.5,0,1,1,0,9,0,1,69,0.99
979,-36.56192046,170,0.5,0.5,0,1,1,0,9,0,1,70,0.99
980,-38.51280504,171,0.5,0.5,0,1,1,0,9,0,1,71,0.99
981,-40.46368961,172,0.5,0.5,0,1,1,0,9,0,1,72,0.99
982,-42.41457419,173,0.5,0.5,0,1,1,0,9,0,1,73,0.99
983,-44.36545877,174,0.5,0.5,0,1,1,0,9,0,1,74,0.99
984,-46.31634335,175,0.5,0.5,0,1,1,0,9,0,1,75,0.99
985,-48.26722793,176,0.5,0.5,0,1,1,0,9,0,1,76,0.99
986,-50.2181125,177,0.5,0.5,0,1,1,0,9,0,1,77,0.99
987,-52.16899708,178,0.5,0.5,0,1,1,0,9,0,1,78,0.99
988,-54.11988166,179,0.5,0.5,0,1,1,0,9,0,1,79,0.99
989,-56.07076624,180,0.5,0.5,0,1,1,0,9,0,1,80,0.99
990,-58.02165082,181,0.5,0.5,0,1,1,0,9,0,1,81,0.99
991,-59.97253539,182,0.5,0.5,0,1,1,0,9,0,1,82,0.99
992,-61.92341997,183,0.5,0.5,0,1,1,0,9,0,1,83,0.99
993,-63.87430455,184,0.5,0.5,0,1,1,0,9,0,1,84,0.99
994,-65.82518913,185,0.5,0.5,0,1,1,0,9,0,1,85,0.99
995,-67.7760737,186,0.5,0.5,0,1,1,0,9,0,1,86,0.99
996,-69.72695828,187,0.5,0.5,0,1,1,0,9,0,1,87,0.99
997,-71.67784286,188,0.5,0.5,0,1,1,0,9,0,1,88,0.99
998,-73.62872744,189,0.5,0.5,0,1,1,0,9,0,1,89,0.99
999,-75.57961202,190,0.5,0.5,0,1,1,0,9,0,1,90,0.99
1000,-77.53049659,191,0.5,0.5,0,1,1,0,9,0,1,91,0.99
1001,-79.48138117,192,0.5,0.5,0,1,1,0,9,0,1,92,0.99
1002,-81.43226575,193,0.5,0.5,0,1,1,0,9,0,1,93,0.99
1003,-83.38315033,194,0.5,0.5,0,1,1,0,9,0,1,94,0.99
1004,-85.33403491,195,0.5,0.5,0,1,1,0,9,0,1,95,0.99
1005,-87.28491948,196,0.5,0.5,0,1,1,0,9,0,1,96,0.99
1006,-89.23580406,197,0.5,0.5,0,1,1,0,9,0,1,97,0.99
1007,-91.18668864,198,0.5,0.5,0,1,1,0,9,0,1,98,0.99
1008,-93.13757322,199,0.5,0.5,0,1,1,0,9,0,1,99,0.99
1009,-95.0884578,200,0.5,0.5,0,1,1,0,9,0,1,100,0.99